18 18 18 18 18 18 18 18 18 18 18 18 18 18 18 18 18 18 18 18 18 18 18 18 18 18 18 18 18 18 18 18 18 18 18 18 18 18 18 18 18 18 18 18 18 18 18 18 18 18 
18 18 18 18 18 18 18 18 18 18 18 18 18 18 18 18 18 18 18 18 18 18 18 18 18 18 18 18 18 18 18 18 18 18 18 18 18 18 18 18 18 18 18 18 18 18 18 18 18 18 
18 18 18 18 18 18 18 18 18 18 18 18 18 18 18 18 18 18 18 18 18 18 18 18 18 18 18 18 18 18 18 18 18 18 18 18 18 18 18 18 18 18 18 18 18 18 18 18 18 18 
18 18 18 18 18 18 18 18 18 18 18 18 18 18 18 18 18 18 18 18 18 18 18 18 18 18 18 18 18 18 18 18 18 18 18 18 18 18 18 18 18 18 18 18 18 18 18 18 18 18 
18 18 18 18 18 18 18 18 18 18 18 18 18 18 18 18 18 18 18 18 18 18 18 18 18 18 18 18 18 18 18 18 18 18 18 18 18 18 18 18 18 18 18 18 18 18 18 18 18 18 
18 18 18 18 18 18 18 18 18 18 18 18 18 18 18 18 18 18 18 18 18 18 18 18 18 18 18 18 18 18 18 18 18 18 18 18 18 18 18 18 18 18 18 18 18 18 18 18 18 18 
18 18 18 18 18 18 18 18 18 18 18 18 18 18 18 18 18 18 18 18 18 18 18 18 18 18 18 18 18 18 18 18 18 18 18 18 18 18 18 18 18 18 18 18 18 18 18 18 18 18 
18 18 18 18 18 18 18 18 18 18 18 18 18 18 18 18 18 18 18 18 18 18 18 18 18 18 18 18 18 18 18 18 18 18 18 18 18 18 18 18 18 18 18 18 18 18 18 18 18 18 
18 18 18 18 18 18 18 18 18 18 18 18 18 18 18 18 18 18 18 18 18 18 18 18 18 18 18 18 18 18 18 18 18 18 18 18 18 18 18 18 18 18 18 18 18 18 18 18 18 18 
18 18 18 18 18 18 18 18 18 18 40 40 40 40 40 40 40 40 40 40 40 40 40 40 40 40 40 40 40 40 40 40 40 40 40 40 40 40 40 40 40 18 18 18 18 18 18 18 18 18 
18 18 18 18 18 18 18 18 18 18 40 38 38 38 38 38 38 38 38 38 38 38 38 38 38 38 38 38 38 38 38 38 38 38 38 38 38 38 38 38 40 18 18 18 18 18 18 18 18 18 
18 18 18 18 18 18 18 18 18 18 40 38 39 40 39 38 39 40 39 38 39 38 39 38 39 38 39 38 39 38 39 38 39 38 39 38 39 38 39 38 40 18 18 18 18 18 18 18 18 18 
18 18 18 18 18 18 18 18 18 18 40 38 38 39 38 61 38 39 38 39 38 39 40 39 40 39 38 39 40 39 38 39 40 39 38 39 40 39 38 38 40 18 18 18 18 18 18 18 18 18 
18 18 18 18 18 18 18 18 18 18 40 38 39 40 39 38 39 40 39 38 39 38 39 40 39 38 39 38 62 63 63 63 63 63 63 63 64 38 39 38 40 18 18 18 18 18 18 18 18 18 
18 18 18 18 18 18 18 18 18 18 40 38 38 39 38 39 40 39 40 39 38 39 38 39 38 39 40 39 65 75 75 75 75 75 75 75 66 39 38 38 40 18 18 18 18 18 18 18 18 18 
18 18 18 18 18 18 18 18 18 18 40 38 39 38 39 38 39 40 39 38 39 40 39 38 39 38 39 38 65 75 75 75 75 75 75 75 66 38 39 38 40 18 18 18 18 18 18 18 18 18 
18 18 18 18 18 18 18 18 18 18 40 38 40 39 38 39 38 39 38 39 40 39 40 39 38 39 38 39 65 75 75 75 75 75 75 75 66 39 38 38 40 18 18 18 18 18 18 18 18 18 
18 18 18 18 18 18 18 18 18 18 40 38 39 38 39 38 39 40 39 38 39 38 39 38 39 38 39 38 65 75 75 75 75 75 75 75 66 38 39 38 40 18 18 18 18 18 18 18 18 18 
18 18 18 18 18 18 18 18 18 18 40 38 38 39 38 39 40 39 40 39 38 39 40 39 38 39 38 39 65 75 75 75 75 75 75 75 66 39 38 38 40 18 18 18 18 18 18 18 18 18 
18 18 18 18 18 18 18 18 18 18 40 38 39 38 39 38 39 40 39 38 39 40 39 40 39 38 39 40 65 75 75 75 75 75 75 75 66 40 39 38 40 18 18 18 18 18 18 18 18 18 
18 18 18 18 18 18 18 18 18 18 40 38 40 39 38 39 38 39 38 39 38 39 38 39 38 39 38 39 67 68 68 68 68 68 68 68 69 39 38 38 40 18 18 18 18 18 18 18 18 18 
18 18 18 18 18 18 18 18 18 18 40 38 39 38 39 38 39 38 39 40 39 38 39 38 39 38 39 38 39 38 39 38 39 40 39 38 39 38 39 38 40 18 18 18 18 18 18 18 18 18 
18 18 18 18 18 18 18 18 18 18 40 38 38 39 38 39 40 39 38 40 38 39 40 39 38 39 38 39 38 39 38 39 38 39 38 39 38 39 38 38 40 18 18 18 18 18 18 18 18 18 
18 18 18 18 18 18 18 18 18 18 40 38 39 40 39 38 39 38 39 40 39 38 39 38 39 38 39 40 39 38 39 40 39 38 39 40 39 38 39 38 40 18 18 18 18 18 18 18 18 18 
18 18 18 18 18 18 18 18 18 18 40 38 38 39 38 39 38 39 38 40 38 39 38 39 40 39 38 39 38 39 38 39 38 39 38 39 38 39 38 38 40 18 18 18 18 18 18 18 18 18 
18 18 18 18 18 18 18 18 18 18 40 38 39 38 39 38 39 38 39 40 39 38 39 38 39 38 39 38 39 38 39 38 39 38 39 40 39 38 39 38 40 18 18 18 18 18 18 18 18 18 
18 18 18 18 18 18 18 18 18 18 40 38 38 39 40 39 40 39 38 40 38 39 40 39 40 39 38 39 38 39 40 39 38 39 38 39 38 39 38 38 40 18 18 18 18 18 18 18 18 18 
18 18 18 18 18 18 18 18 18 18 40 38 39 40 40 40 40 40 40 40 40 40 40 40 40 40 39 38 39 38 39 38 39 40 39 38 39 40 39 38 40 18 18 18 18 18 18 18 18 18 
18 18 18 18 18 18 18 18 18 18 40 38 38 40 38 39 38 39 38 39 38 39 38 39 38 40 38 39 38 39 38 39 38 39 38 39 38 39 38 38 40 18 18 18 18 18 18 18 18 18 
18 18 18 18 18 18 18 18 18 18 40 38 39 40 39 38 39 38 39 38 61 38 39 38 39 40 39 38 39 38 39 40 39 40 39 40 39 38 39 38 40 18 18 18 18 18 18 18 18 18 
18 18 18 18 18 18 18 18 18 18 40 38 38 40 38 39 38 39 40 39 38 39 38 39 38 40 38 39 38 39 38 39 38 39 38 39 40 39 38 38 40 18 18 18 18 18 18 18 18 18 
18 18 18 18 18 18 18 18 18 18 40 38 39 40 39 38 39 40 39 38 39 38 39 38 39 40 39 38 39 38 39 40 39 38 39 38 39 40 39 38 40 18 18 18 18 18 18 18 18 18 
18 18 18 18 18 18 18 18 18 18 40 38 38 40 38 39 40 39 38 39 38 39 38 39 38 40 38 39 38 39 38 39 38 39 40 39 38 39 38 38 40 18 18 18 18 18 18 18 18 18 
18 18 18 18 18 18 18 18 18 18 40 38 39 40 39 38 39 38 39 38 39 38 39 38 39 40 39 38 39 38 39 38 39 40 39 38 39 38 39 38 40 18 18 18 18 18 18 18 18 18 
18 18 18 18 18 18 18 18 18 18 40 38 38 40 38 39 38 39 38 39 38 39 40 39 38 40 38 39 38 39 38 39 38 39 38 39 40 39 40 38 40 18 18 18 18 18 18 18 18 18 
18 18 18 18 18 18 18 18 18 18 40 38 39 40 39 38 39 38 39 38 39 40 39 40 39 40 39 38 39 40 39 38 39 38 39 38 39 38 39 38 40 18 18 18 18 18 18 18 18 18 
18 18 18 18 18 18 18 18 18 18 40 38 38 40 38 39 38 39 38 39 38 39 38 39 38 40 38 39 38 39 38 39 40 39 38 39 38 39 38 38 40 18 18 18 18 18 18 18 18 18 
18 18 18 18 18 18 18 18 18 18 40 38 39 40 40 40 39 38 39 38 39 38 39 40 40 40 39 38 39 38 39 38 39 38 39 40 39 40 39 38 40 18 18 18 18 18 18 18 18 18 
18 18 18 18 18 18 18 18 18 18 40 38 38 39 38 38 38 39 38 39 38 39 38 39 38 39 38 39 38 39 38 39 38 39 38 39 38 39 38 38 40 18 18 18 18 18 18 18 18 18 
18 18 18 18 18 18 18 18 18 18 40 38 38 38 38 38 38 38 38 38 38 38 38 38 38 38 38 38 38 38 38 38 38 38 38 38 38 38 38 38 40 18 18 18 18 18 18 18 18 18 
18 18 18 18 18 18 18 18 18 18 40 38 38 38 38 38 38 38 38 38 38 38 38 38 38 38 38 38 38 38 38 38 38 38 38 38 38 38 38 38 40 18 18 18 18 18 18 18 18 18 
18 18 18 18 18 18 18 18 18 18 40 40 40 40 40 40 40 40 40 40 40 40 40 40 40 40 40 40 40 40 40 40 40 40 40 40 40 40 40 40 40 18 18 18 18 18 18 18 18 18 
18 18 18 18 18 18 18 18 18 18 18 18 18 18 18 18 18 18 18 18 18 18 18 18 18 18 18 18 18 18 18 18 18 18 18 18 18 18 18 18 18 18 18 18 18 18 18 18 18 18 
18 18 18 18 18 18 18 18 18 18 18 18 18 18 18 18 18 18 18 18 18 18 18 18 18 18 18 18 18 18 18 18 18 18 18 18 18 18 18 18 18 18 18 18 18 18 18 18 18 18 
18 18 18 18 18 18 18 18 18 18 18 18 18 18 18 18 18 18 18 18 18 18 18 18 18 18 18 18 18 18 18 18 18 18 18 18 18 18 18 18 18 18 18 18 18 18 18 18 18 18 
18 18 18 18 18 18 18 18 18 18 18 18 18 18 18 18 18 18 18 18 18 18 18 18 18 18 18 18 18 18 18 18 18 18 18 18 18 18 18 18 18 18 18 18 18 18 18 18 18 18 
18 18 18 18 18 18 18 18 18 18 18 18 18 18 18 18 18 18 18 18 18 18 18 18 18 18 18 18 18 18 18 18 18 18 18 18 18 18 18 18 18 18 18 18 18 18 18 18 18 18 
18 18 18 18 18 18 18 18 18 18 18 18 18 18 18 18 18 18 18 18 18 18 18 18 18 18 18 18 18 18 18 18 18 18 18 18 18 18 18 18 18 18 18 18 18 18 18 18 18 18 
18 18 18 18 18 18 18 18 18 18 18 18 18 18 18 18 18 18 18 18 18 18 18 18 18 18 18 18 18 18 18 18 18 18 18 18 18 18 18 18 18 18 18 18 18 18 18 18 18 18 
18 18 18 18 18 18 18 18 18 18 18 18 18 18 18 18 18 18 18 18 18 18 18 18 18 18 18 18 18 18 18 18 18 18 18 18 18 18 18 18 18 18 18 18 18 18 18 18 18 18 
