43 43 43 43 43 43 43 43 43 43 43 43 43 43 43 43 43 43 43 43 43 43 43 43 43 43 43 43 43 43 43 43 43 43 43 43 43 43 43 43 43 43 43 43 43 43 43 43 43 43 
43 52 50 50 50 50 50 50 50 50 50 50 50 50 50 50 50 50 50 50 50 50 50 50 50 50 50 50 50 50 50 50 50 50 50 50 50 50 50 50 50 50 50 50 50 50 50 50 53 43 
43 48 42 42 42 42 42 42 42 42 42 42 42 42 42 42 42 42 42 42 42 42 42 42 42 42 42 42 42 42 42 42 42 42 42 42 42 42 42 42 42 42 42 42 42 42 42 42 47 43 
43 48 42 42 42 42 42 42 42 44 45 46 42 42 42 42 42 42 42 42 42 42 42 42 42 42 42 42 42 42 42 42 42 44 45 46 42 42 42 42 42 42 42 42 42 42 42 42 47 43 
43 48 42 42 42 42 61 42 42 47 43 48 42 42 42 42 42 42 42 42 42 42 42 42 42 42 42 42 42 42 42 42 42 47 43 48 42 42 42 42 42 42 42 42 42 42 42 42 47 43 
43 48 42 42 42 42 42 42 42 49 50 51 42 42 42 42 42 42 42 42 42 42 42 42 42 42 42 42 42 42 42 42 42 49 50 51 42 42 42 42 42 42 42 42 42 42 42 42 47 43 
43 48 42 42 42 42 42 42 42 42 42 42 42 42 42 42 44 45 46 42 42 42 42 42 42 42 42 42 42 42 42 42 42 42 42 42 42 42 42 42 42 42 44 45 46 42 42 42 47 43 
43 48 42 42 42 42 42 42 42 42 42 42 42 42 42 42 47 43 48 42 42 42 42 42 42 42 42 42 42 42 42 42 42 42 42 42 42 42 42 42 42 42 47 43 48 42 42 42 47 43 
43 48 42 42 42 42 42 42 42 42 42 42 42 42 42 42 49 50 51 42 42 42 42 42 42 42 42 42 42 42 42 42 42 42 42 42 42 42 42 42 42 42 49 50 51 42 42 42 47 43 
43 48 42 42 42 42 42 42 42 42 42 42 42 42 42 42 42 42 42 42 42 42 42 42 42 42 42 42 42 42 42 42 42 42 42 42 42 42 42 42 42 42 42 42 42 42 42 42 47 43 
43 54 45 45 45 45 45 45 45 45 45 45 45 45 45 45 45 45 45 45 45 45 46 42 42 42 42 44 45 45 45 45 45 45 45 45 45 45 45 45 45 45 45 45 45 45 45 45 55 43 
43 43 43 43 43 43 43 43 43 43 43 43 43 43 43 43 43 43 43 43 43 43 48 42 42 42 42 49 50 53 43 43 43 43 43 43 43 43 43 43 43 43 43 43 43 43 43 43 43 43 
43 43 43 43 43 43 43 43 43 43 43 43 43 43 43 43 43 43 43 43 43 43 54 45 46 42 42 42 42 49 53 43 43 43 43 43 43 43 43 43 43 43 43 43 43 43 43 43 43 43 
43 43 43 43 43 43 43 43 43 43 43 43 43 43 43 43 43 43 43 43 43 43 43 43 54 45 46 42 42 42 49 53 43 43 43 43 43 43 43 43 43 43 43 43 43 43 43 43 43 43 
43 43 43 43 43 43 43 43 43 43 43 43 43 43 43 43 43 43 43 43 43 43 43 43 43 43 48 42 42 42 42 47 43 43 43 43 43 43 43 43 43 43 43 43 43 43 43 43 43 43 
43 43 43 43 43 43 43 43 43 43 43 43 43 43 43 43 43 43 43 43 43 43 43 43 43 43 48 42 42 42 42 47 43 43 43 43 43 43 43 43 43 43 43 43 43 43 43 43 43 43 
43 43 43 52 50 50 50 50 50 50 50 50 50 50 50 50 50 50 50 50 50 50 53 43 43 43 48 42 42 42 42 49 50 50 50 50 50 50 50 50 50 50 50 50 50 50 50 50 53 43 
43 43 43 48 42 42 42 42 42 42 42 42 42 42 42 42 42 42 42 42 42 42 47 43 43 43 48 42 42 42 42 42 42 42 42 42 42 42 42 42 42 42 42 42 42 42 42 42 47 43 
43 43 43 48 42 42 42 42 42 42 42 42 42 42 42 42 42 42 42 42 42 42 47 43 43 43 48 42 42 42 42 42 42 42 42 42 42 42 42 42 42 42 42 42 42 42 42 42 47 43 
43 43 43 48 42 42 44 45 46 42 42 42 42 42 42 42 42 44 45 46 42 42 47 43 43 43 48 42 42 42 42 42 42 42 42 42 42 42 42 42 42 42 42 42 42 42 42 42 47 43 
43 43 43 48 42 42 47 43 48 42 42 42 42 42 42 42 42 47 43 48 42 42 47 43 43 43 48 42 42 42 42 42 42 42 42 42 42 42 42 42 42 42 42 42 42 42 42 42 47 43 
43 43 43 48 42 42 49 50 51 42 42 42 42 42 42 42 42 49 50 51 42 42 47 43 43 43 48 42 42 42 42 42 42 42 42 42 42 42 42 42 42 42 42 42 42 42 42 42 47 43 
43 43 43 48 42 42 42 42 42 42 42 42 42 42 42 42 42 42 42 42 42 42 47 43 43 43 48 42 42 42 42 42 42 44 45 45 45 45 45 45 45 45 45 45 45 45 46 42 47 43 
43 43 43 48 42 42 42 42 42 42 42 42 42 42 42 42 42 42 42 42 42 42 47 43 43 43 48 42 42 42 42 42 42 47 43 43 43 43 43 43 43 43 43 43 43 43 48 42 47 43 
43 43 43 54 45 45 45 45 45 45 45 45 46 42 44 45 45 45 45 45 45 45 55 43 43 43 48 42 42 42 42 42 42 47 43 43 43 43 43 43 43 43 43 43 43 43 48 42 47 43 
43 43 43 43 43 43 43 43 43 43 43 43 48 42 47 43 43 43 43 43 43 43 43 43 43 43 48 42 42 42 42 42 42 47 43 43 43 43 43 43 43 43 43 43 43 43 48 42 47 43 
43 43 43 43 43 43 43 43 43 43 43 52 51 42 49 53 43 43 43 43 43 43 43 43 43 43 48 42 42 42 42 42 42 47 43 43 43 43 43 43 43 43 43 43 43 43 48 42 47 43 
43 43 43 52 50 50 50 50 50 50 50 51 42 42 42 49 50 50 50 50 50 50 53 43 43 43 48 42 42 42 42 42 42 49 50 50 53 43 43 43 43 43 43 43 43 43 48 42 47 43 
43 43 43 48 42 42 42 42 42 42 42 42 42 42 42 42 42 42 42 42 42 42 47 43 43 43 48 42 42 42 42 42 42 42 42 42 47 43 43 43 43 43 43 43 43 43 48 42 47 43 
43 43 43 48 42 42 42 42 42 42 42 42 42 42 42 42 42 42 42 42 42 42 47 43 43 43 48 42 42 42 42 42 42 42 42 42 47 43 43 43 43 43 43 43 43 43 48 42 47 43 
43 43 43 48 42 42 42 42 42 42 42 42 42 42 42 42 42 42 42 42 42 42 47 43 43 43 48 42 42 42 42 42 42 42 42 42 47 43 43 43 43 43 43 43 43 43 48 42 47 43 
43 43 43 48 42 42 42 42 42 42 42 42 42 42 42 42 42 44 45 46 42 42 47 43 43 43 48 42 42 42 42 42 42 42 42 42 49 50 50 50 53 43 43 43 43 43 48 42 47 43 
43 43 43 48 42 42 44 45 46 42 42 42 42 42 42 42 42 47 43 48 42 42 47 43 43 43 48 42 42 42 42 42 42 42 42 42 42 42 42 42 47 43 43 43 43 43 48 42 47 43 
43 43 43 48 42 42 47 43 48 42 42 42 42 42 42 42 42 49 50 51 42 42 47 43 43 43 48 42 42 42 42 42 42 42 42 42 42 42 42 42 47 43 43 43 43 43 48 42 47 43 
43 43 43 48 42 42 49 50 51 42 42 42 42 42 42 42 42 42 42 42 42 42 47 43 43 43 48 42 42 42 42 42 42 42 42 42 42 42 42 42 47 43 43 43 43 43 48 42 47 43 
43 43 43 48 42 42 42 42 42 42 42 42 42 42 42 42 42 42 42 42 42 42 47 43 43 43 48 42 42 42 42 44 45 46 42 42 42 42 42 42 47 43 43 43 43 43 48 42 47 43 
43 43 43 48 42 42 42 42 42 42 42 42 42 42 42 42 42 42 42 42 42 42 47 43 43 43 48 42 42 42 42 47 43 48 42 42 42 42 42 42 49 50 50 53 43 43 48 42 47 43 
43 43 43 48 42 42 42 42 42 42 42 42 42 42 42 42 42 42 42 42 42 42 47 43 43 43 48 42 42 42 42 49 50 51 42 42 42 42 42 42 42 42 42 47 43 43 48 42 47 43 
43 43 43 48 42 42 42 42 42 42 42 42 42 42 42 42 42 42 42 42 42 42 47 43 43 43 48 42 42 42 42 42 42 42 42 42 42 42 42 42 42 42 42 47 43 43 48 42 47 43 
43 43 43 48 42 42 42 42 42 44 45 46 42 42 42 42 42 42 42 42 42 42 47 43 43 43 48 42 42 42 42 42 42 42 42 42 42 42 42 42 42 42 42 49 50 50 51 42 47 43 
43 43 43 48 42 42 42 42 42 47 43 48 42 42 42 42 42 42 42 42 42 42 47 43 43 43 48 42 42 42 42 42 42 42 42 42 42 42 42 42 42 42 42 42 42 42 42 42 47 43 
43 43 43 48 42 42 42 42 42 49 50 51 42 42 42 42 42 42 42 42 42 42 49 50 50 50 51 42 42 42 42 42 42 42 42 42 42 42 42 42 42 42 42 42 42 42 42 42 47 43 
43 43 43 48 42 42 42 42 42 42 42 42 42 42 42 42 42 42 42 42 42 42 42 42 42 42 42 42 42 42 42 42 42 42 42 42 42 44 45 46 42 42 42 42 42 42 42 42 47 43 
43 43 43 48 42 42 42 42 42 42 42 42 42 42 42 42 42 42 42 42 42 42 42 42 42 42 42 42 42 42 42 42 42 42 42 42 42 47 43 48 42 42 42 42 42 42 42 42 47 43 
43 43 43 48 42 42 42 42 42 42 42 42 42 42 42 42 42 42 42 42 42 42 44 45 45 45 46 42 42 42 42 42 42 42 42 42 42 49 50 51 42 42 42 42 42 42 42 42 47 43 
43 43 43 48 42 42 42 42 42 42 42 42 42 42 42 42 42 42 42 42 42 42 47 43 43 43 48 42 42 42 42 42 42 42 42 42 42 42 42 42 42 42 42 42 42 42 42 42 47 43 
43 43 43 54 45 45 45 45 45 45 45 45 45 45 45 45 45 45 45 45 45 45 55 43 43 43 48 42 42 42 42 42 42 42 42 42 42 42 42 42 42 42 42 42 42 42 42 42 47 43 
43 43 43 43 43 43 43 43 43 43 43 43 43 43 43 43 43 43 43 43 43 43 43 43 43 43 48 42 42 42 42 42 42 42 42 42 42 42 42 42 42 42 42 42 42 42 42 42 47 43 
43 43 43 43 43 43 43 43 43 43 43 43 43 43 43 43 43 43 43 43 43 43 43 43 43 43 54 45 45 45 45 45 45 45 45 45 45 45 45 45 45 45 45 45 45 45 45 45 55 43 
43 43 43 43 43 43 43 43 43 43 43 43 43 43 43 43 43 43 43 43 43 43 43 43 43 43 43 43 43 43 43 43 43 43 43 43 43 43 43 43 43 43 43 43 43 43 43 43 43 43